NO ./textures/north.xpm

SO ./textures/south.xpm

WE ./textures/west.xpm

EA ./textures/east.xpm

F 20,50, 10

C 0, 0, 255

        111111111111111111111111
        1100000000110000000000001
        101100000111000S001000001
        1001010000000000011000001
111111111011000001110010000000001
100000010011000001110101111111111
1111011 111111011100000010001
11110111111111011101010010001
10000001101010111000000010001
10000000000000001100000010001
10000000000000001101010010001
1100000111010101111101111000111
11110111 1110101 101111010001
11111111 1111111 111111111111

